1password-cli: (1Password CLI) Command-line interface for 1Password
airflow: (Airflow) Watch local content on Apple TV and Chromecast
amazon-chime: (Amazon Chime) Communications service
appcleaner: (FreeMacSoft AppCleaner) Application uninstaller
diffusionbee: (Diffusion Bee) Run Stable Diffusion locally
discord: (Discord) Voice and text chat software
dropbox: (Dropbox) Client for the Dropbox cloud storage service
expressvpn: (ExpressVPN) VPN client for secure internet access and private browsing
font-jetbrains-mono: (JetBrains Mono) [no description]
font-jetbrains-mono-nerd-font: (JetBrainsMono Nerd Font families (JetBrains Mono)) [no description]
font-metropolis: (Metropolis) [no description]
font-monaspace: (Monaspace) [no description]
font-monaspace-nerd-font: (Monaspice Nerd Font families (Monaspace)) [no description]
font-noto-color-emoji: (Noto Color Emoji) [no description]
font-roboto-condensed: (Roboto Condensed) [no description]
font-roboto-mono: (Roboto Mono) [no description]
github: (GitHub Desktop) Desktop client for GitHub repositories
google-chrome: (Google Chrome) Web browser
keybase: (Keybase) End-to-end encryption software
lm-studio: (LM Studio) Discover, download, and run local LLMs
mactex: (MacTeX) Full TeX Live distribution with GUI applications
macwhisper: (MacWhisper) Speech recognition tool
ollama: (Ollama) Get up and running with large language models locally
onyx: (OnyX) Verify system files structure, run miscellaneous maintenance and more
opencpn: (OpenCPN) Full-featured and concise ChartPlotter/Navigator
orbstack: (OrbStack) Replacement for Docker Desktop
phocus: (Hasselblad Phocus) RAW file image processing software for Hasselblad cameras
quarto: (quarto) Scientific and technical publishing system built on Pandoc
raycast: (Raycast) Control your tools with a few keystrokes
rectangle: (Rectangle) Move and resize windows using keyboard shortcuts or snap areas
sage: (Sage) Mathematics software system
skim: (Skim) PDF reader and note-taking application
temurin: (Eclipse Temurin Java Development Kit) JDK from the Eclipse Foundation (Adoptium)
toinane-colorpicker: (Colorpicker) Get and save colour codes
transmission: (Transmission) Open-source BitTorrent client
visual-studio-code: (Microsoft Visual Studio Code, VS Code) Open-source code editor
visualvm: (VisualVM) All-in-One Java Troubleshooting Tool
vlc: (VLC media player) Multimedia player
vuescan: (VueScan) App that provides drivers for older model scanners that are no longer supported
zoom: (Zoom) Video communication and virtual meeting platform
zulip: (Zulip) Desktop client for the Zulip team chat platform
